0 0 0 0 0 0 0 0 0 0 0 0 0 0 0 0 2
0 0 0 0 0 0 0 0 0 0 0 0 0 0 0 0 2
0 0 0 0 0 0 0 0 0 0 0 0 0 0 0 0 2
0 0 0 0 0 0 0 0 0 0 0 0 0 0 0 0 2
0 0 0 0 0 0 0 0 0 0 0 0 0 0 0 0 2
0 0 0 0 0 0 0 0 0 0 0 0 0 0 0 0 2
0 0 0 0 0 0 0 0 0 0 0 0 0 0 0 0 2
0 0 0 0 0 0 0 0 0 0 0 0 0 0 0 0 2
0 0 0 0 0 0 0 0 0 0 0 0 0 0 0 0 2
0 0 0 0 0 0 0 0 0 0 0 0 0 0 0 0 2
0 0 0 0 0 0 0 0 0 0 0 0 0 0 0 0 2
0 0 0 0 0 0 0 0 0 0 0 0 0 0 0 0 2
0 0 0 0 0 0 0 0 0 0 0 0 0 0 0 0 2
0 0 0 0 0 0 0 0 0 0 0 0 0 0 0 0 2
0 0 0 0 0 0 0 0 0 0 0 0 0 0 0 0 2
0 0 0 0 0 0 0 0 0 0 0 0 0 0 0 0 2
0 0 0 0 0 0 0 0 0 0 0 0 0 0 0 0 2

0 0 0 0 0 0 0 0 0 0 0 0 0 0 0 0 2
0 0 0 0 0 0 0 0 0 0 0 0 0 0 0 2 2
0 0 0 0 0 0 0 0 0 0 0 0 0 0 0 2 2
0 0 0 0 0 0 0 0 0 0 0 0 0 0 0 2 2
0 0 0 0 0 0 0 0 0 0 0 0 0 0 0 2 2
0 0 0 0 0 0 0 0 0 0 0 0 0 0 2 2 2
0 0 0 0 0 0 0 0 0 0 0 0 0 0 2 2 2
0 0 0 0 0 0 0 0 0 0 0 0 0 0 2 2 2
0 0 0 0 0 0 0 0 0 0 0 0 0 0 2 2 2
0 0 0 0 0 0 0 0 0 0 0 0 0 0 2 2 2
0 0 0 0 0 0 0 0 0 0 0 0 0 0 2 2 2
0 0 0 0 0 0 0 0 0 0 0 0 0 0 2 2 2
0 0 0 0 0 0 0 0 0 0 0 0 0 0 2 2 2
0 0 0 0 0 0 0 0 0 0 0 0 0 0 2 2 2
0 0 0 0 0 0 0 0 0 0 0 0 0 0 2 2 2
0 0 0 0 0 0 0 0 0 0 0 0 0 0 2 2 2
0 0 0 0 0 0 0 0 0 0 0 0 0 0 2 2 2

0 0 0 0 0 0 0 0 0 0 52 52 52 52 1 1 2
0 0 0 0 0 0 0 0 0 52 0 0 0 0 1 2 2
0 0 0 0 0 0 0 0 0 0 0 0 0 0 0 2 2
0 0 0 0 0 0 0 0 0 22 22 0 22 22 22 2 2
0 0 0 0 0 0 0 0 0 20 20 20 50 50 50 2 2
0 0 0 0 0 0 0 0 0 0 0 0 0 0 2 2 2
0 0 0 0 0 0 0 0 0 0 0 10 0 2 2 2 2
0 0 0 0 0 0 0 0 0 0 10 10 0 2 2 2 2
0 0 0 0 0 0 0 0 0 0 10 10 10 2 2 2 2
0 0 0 0 0 0 0 0 0 10 10 10 10 2 2 2 2
0 0 0 0 0 0 0 0 0 0 10 10 20 2 2 2 2
0 0 0 0 0 0 0 0 0 0 10 10 20 2 2 2 2
0 0 0 0 0 0 0 0 0 0 0 0 0 2 2 2 2
0 0 0 30 30 30 0 0 0 22 22 0 2 2 2 2 2
0 0 0 30 30 30 0 0 22 22 22 0 2 2 2 2 2
0 0 0 30 30 30 30 0 0 22 22 0 2 2 2 2 2
0 0 0 30 30 30 30 0 0 0 0 2 2 2 2 2 2

0 0 0 0 0 0 20 20 20 -1 -1 -1 -1 -1 -1 -1 -1
0 0 0 0 0 0 0 0 20 -1 -1 -1 -1 -1 -1 -1 -1
0 0 0 0 0 0 0 -1 -1 -1 -1 -1 -1 -1 -1 -1 -1
0 0 0 0 0 0 0 0 0 12 -1 -1 -1 -1 -1 -1 -1
0 0 0 0 0 0 0 0 12 -1 -1 -1 -1 -1 -1 -1 -1
0 0 0 0 0 22 22 -1 -1 -1 -1 -1 -1 -1 -1 -1 -1
0 0 0 0 0 0 22 22 22 -1 -1 -1 -1 -1 -1 -1 -1
0 0 0 0 0 0 1 -1 -1 -1 -1 -1 -1 -1 -1 -1 -1
0 0 0 0 12 12 -1 -1 -1 -1 -1 -1 -1 -1 -1 -1 -1
0 0 0 12 12 -1 -1 -1 -1 -1 -1 -1 -1 -1 -1 -1 -1
12 12 -1 -1 -1 -1 -1 -1 -1 -1 -1 -1 -1 -1 -1 -1 -1
-1 -1 -1 -1 -1 -1 -1 -1 -1 -1 -1 -1 -1 -1 -1 -1 -1
-1 -1 -1 -1 -1 -1 -1 -1 -1 -1 -1 -1 -1 -1 -1 -1 -1
1 1 -1 -1 -1 -1 -1 -1 -1 -1 -1 -1 -1 -1 -1 -1 -1
0 0 1 -1 -1 -1 -1 -1 -1 -1 -1 -1 -1 -1 -1 -1 -1
0 0 1 -1 -1 -1 -1 -1 -1 -1 -1 -1 -1 -1 -1 -1 -1
0 0 0 -1 -1 -1 -1 -1 -1 -1 -1 -1 -1 -1 -1 -1 -1

1 1 1 1 1 0 20 20 20 -1 -1 -1 -1 -1 -1 -1 -1
1 1 1 1 0 0 0 0 20 -1 -1 -1 -1 -1 -1 -1 -1
1 1 1 0 12 0 0 -1 -1 -1 -1 -1 -1 -1 -1 -1 -1
1 1 1 12 12 0 0 0 0 -1 -1 -1 -1 -1 -1 -1 -1
1 1 52 0 0 0 0 0 -1 -1 -1 -1 -1 -1 -1 -1 -1
0 0 52 0 1 -1 -1 -1 -1 -1 -1 -1 -1 -1 -1 -1 -1
0 0 0 0 1 1 -1 -1 -1 -1 -1 -1 -1 -1 -1 -1 -1
0 0 12 12 0 0 -1 -1 -1 -1 -1 -1 -1 -1 -1 -1 -1
0 0 0 0 -1 -1 -1 -1 -1 -1 -1 -1 -1 -1 -1 -1 -1
0 0 0 -1 -1 -1 -1 -1 -1 -1 -1 -1 -1 -1 -1 -1 -1
-1 -1 -1 -1 -1 -1 -1 -1 -1 -1 -1 -1 -1 -1 -1 -1 -1
-1 -1 -1 -1 -1 -1 -1 -1 -1 -1 -1 -1 -1 -1 -1 -1 -1
-1 -1 -1 -1 -1 -1 -1 -1 -1 -1 -1 -1 -1 -1 -1 -1 -1
-1 -1 -1 -1 -1 -1 -1 -1 -1 -1 -1 -1 -1 -1 -1 -1 -1
1 1 -1 -1 -1 -1 -1 -1 -1 -1 -1 -1 -1 -1 -1 -1 -1
1 1 -1 -1 -1 -1 -1 -1 -1 -1 -1 -1 -1 -1 -1 -1 -1
1 1 1 -1 -1 -1 -1 -1 -1 -1 -1 -1 -1 -1 -1 -1 -1